+---+---+---+---+---+---+---+---+---+---+
| P         |           |           |    
+---+---+   +   +   +   +---+   +   +   +
|   |       |   |   |       |   |        
+   +   +---+   +   +---+   +   +---+   +
|   |       |   |   |   |   |   |        
+   +---+   +---+   +   +   +   +---+---+
|       |           |       |            
+   +   +---+---+---+   +---+---+   +   +
|   |       |       |           |   |    
+   +---+   +---+   +---+---+   +---+   +
|   |                   |       |        
+   +---+---+---+---+---+   +---+   +   +
|       |               |           |    
+   +   +   +---+---+   +---+---+---+   +
|   |       |       |       |            
+   +---+---+   +   +   +---+   +---+---+
|               |   |           |        
+---+---+---+---+   +---+---+---+   +   +
|                                   | G  
+---+---+---+---+---+---+---+---+---+---+
